zxy_pacbio_ccs_megahit	/mnt/osf2/user/liaoherui/LAEP/MaxBin/zxy/pacbio_ccs_megahit
zxy_10x_barcodestrip	/mnt/osf2/user/liaoherui/LAEP/MaxBin/zxy/10x_barcodestrip
zxy_pacbio_HGA	/mnt/osf2/user/liaoherui/LAEP/MaxBin/zxy/pacbio_HGA
zxy_illumina	/mnt/osf2/user/liaoherui/LAEP/MaxBin/zxy/illumina
zxy_10x_pacbio_athena	/mnt/osf2/user/liaoherui/LAEP/MaxBin/zxy/10x_pacbio_athena
zxy_BGIseq	/mnt/osf2/user/liaoherui/LAEP/MaxBin/zxy/BGIseq
zxy_10x_athena	/mnt/osf2/user/liaoherui/LAEP/MaxBin/zxy/10x_athena
zxy_BGIseq_pacbio	/mnt/osf2/user/liaoherui/LAEP/MaxBin/zxy/BGIseq_pacbio
zxy_pacbio_flyer	/mnt/osf2/user/liaoherui/LAEP/MaxBin/zxy/pacbio_flyer
zxy_illumina_pacbio	/mnt/osf2/user/liaoherui/LAEP/MaxBin/zxy/illumina_pacbio
hlj_illumina	/mnt/osf2/user/liaoherui/LAEP/MaxBin/hlj/illumina
hlj_BGIseq_pacbio	/mnt/osf2/user/liaoherui/LAEP/MaxBin/hlj/BGIseq_pacbio
hlj_illumina_pacbio	/mnt/osf2/user/liaoherui/LAEP/MaxBin/hlj/illumina_pacbio
hlj_10x_athena	/mnt/osf2/user/liaoherui/LAEP/MaxBin/hlj/10x_athena
hlj_10x_pacbio_athena	/mnt/osf2/user/liaoherui/LAEP/MaxBin/hlj/10x_pacbio_athena
hlj_pacbio_HGA	/mnt/osf2/user/liaoherui/LAEP/MaxBin/hlj/pacbio_HGA
hlj_pacbio_flyer	/mnt/osf2/user/liaoherui/LAEP/MaxBin/hlj/pacbio_flyer
hlj_BGIseq	/mnt/osf2/user/liaoherui/LAEP/MaxBin/hlj/BGIseq
hlj_pacbio_ccs_megahit	/mnt/osf2/user/liaoherui/LAEP/MaxBin/hlj/pacbio_ccs_megahit
hlj_10x_barcodestrip	/mnt/osf2/user/liaoherui/LAEP/MaxBin/hlj/10x_barcodestrip
